NO _Ice.xpm
SO _Mud.xpm
WE _WaterF1.xpm
EA _LeavesOP.xpm

F 220, 100, 0
C 10, 10, 0

1111111111111111111
100N000011111000001
1010000011001000001
1000110000001000001
1000110000000000001
1000000000000000001
1000111001111000001
1111111111  1111111