11111
1P0E1
1CCC1
1M001
11111
